955539793B
8393AAD2AA
AAAAEA96AA
AAAA96ABC2
AC6C69687A
C53952943A
97AC3AA96A
85696AAC56
C3D696C53B
D4556D5546


1,1
10,10
