D13D393B93
96C56AAC6A
853956C396
ABC693D683
A83D2A956A
C6C3AAA97A
9556AAAC3A
AD552EC52A
C553C5556A
D554555556


1,1
10,10
