B955515557
A8557C5553
869555393A
E92D53C6AA
96A93C156A
A96AC7C53A
AC3AD55542
AD6C5553BA
A955553A86
C45557C6C7


1,1
10,10
