FFFFFFF93F953FFFFFFFFFFFFFFFFFFFFFFFFFFF
FFFFFFFAC56BAF9553FFFFFFFFFFFFFFFFFFFFFF
FFFFFFFC3956C5693C3FFFFFFFFFFFFFFFFFFFFF
FFFFFFFFA855153E87C3FFFFFFFFFFFFFFFFFFFF
FFFFFFFFAC396BC16956FFFFFFFFFFFFFFFFFFFF
FFFFFFFFAD683A9696FFFFFFFFFFFFFFFFFFFFFF
FFFFF953853EAA87AFFFFFFFFFFFFFFFFFFFFFFF
FFFF9696C7A96C696FFFFFFFFFFFFFFFFFFFFFFF
FFF96FC5556C3956953FFFFFFFFFFFFFFFFFFFFF
FFFA93FFFFFFC6FFC3AFFFFFFFFFFFFFFFFFFFFF
FFFC6AFFFFFFFFFFFAAFFFFFFFFFFFFFFFFFFFFF
FFFFFC53FFFFFFFFFAC3FFFFFFFFFFFFFFFFFFFF
FFFFFFFAFFFFFFFFF87AFFFFFFFFFFFFFFFFFFFF
FFFF9556FFFFFFF95696957FFFFFFFFFFFFFFFFF
FFFFC3FF953FFFFAFFC56FFFFFFFFFFFFFFFFFFF
FFFFFC3FA96FFF96FFFFFFFFFFFFFFFFFFFFFFFF
FFFFFFC56C3FFFC3FFFFFFFFFFFFFFFFFFFFFFFF
FFFFFFFFF96FFF96FFFFFFFFFFFFFFFFFFFFFFFF
FFFFFFFF96FFFFC3FFFFFFFFFFFFFFFFFFFFFFFF
FFFFFFFFC5553F96FFFFFFFFFFFFFFFFFFFFFFFF
FFFFFFFFFFFFC3A93FFFFFFFFFFFFFFFFFFFFFFF
FFFFFFFFFFFFFAC6AFFFFFFFFFFFFFFFFFFFFFFF
FFFFFFFFFFFFF853C53FFFFFFFFFFFFFFFFFFFFF
FFFFFFFFFFFFFA96B96FFFFFFFFFFFFFFFFFFFFF
FFFFFFFFFFFFFAC3AAFFFFFFFFFFFFFFFFFFFFFF
FFFFFFFFFFFFFAD46C3FFFFFFFFFFFFFFFFFFFFF
FFFFFFFFFFFF9695556FFFFFFFFFFFFFFFFFFFFF
FFFFFFFFFFFFAFAFFFFFFFFFFFFFFFFFFFFFFFFF
FFFFFFFFFFFFC56FFFFFFFFFFFFFFFFFFFFFFFFF
FFFFFFFFFFFFFFFFFFFFFFFFFFFFFFFFFFFFFFFF
FFFFFFFFFFFFFFFFFFFFFFFFFFFFFFFFFFFFFFFF
FFFFFFFFFFFFFFFFFFFFFFFFFFFFFFFFFFFFFFFF
FFFFFFFFFFFFFFFFFFFFFFFFFFFFFFFFFFFFFFFF
FFFFFFFFFFFFFFFFFFFFFFFFFFFFFFFFFFFFFFFF
FFFFFFFFFFFFFFFFFFFFFFFFFFFFFFFFFFFFFFFF
FFFFFFFFFFFFFFFFFFFFFFFFFFFFFFFFFFFFFFFF
FFFFFFFFFFFFFFFFFFFFFFFFFFFFFFFFFFFFFFFF
FFFFFFFFFFFFFFFFFFFFFFFFFFFFFFFFFFFFFFFF
FFFFFFFFFFFFFFFFFFFFFFFFFFFFFFFFFFFFFFFF
FFFFFFFFFFFFFFFFFFFFFFFFFFFFFFFFFFFFFFFF


1,1
10,10
